2,2,2,2,2,2,2,2,2,2,0,2,2,2,2,2,2,2,2,2,
2,2,2,0,0,2,2,2,2,2,0,2,2,2,2,2,2,0,2,2,
2,2,0,0,2,2,2,0,2,2,0,2,2,2,2,2,2,0,2,2,
2,0,0,2,2,2,2,0,2,2,0,2,2,2,0,2,2,0,2,2,
2,0,2,2,2,2,2,0,2,2,0,2,2,2,0,2,2,0,2,2,
2,2,2,2,2,2,2,0,2,2,0,2,2,2,0,2,2,0,2,2,
2,2,2,0,0,0,0,0,2,2,0,2,2,2,0,2,2,0,2,2,
2,2,2,2,2,2,2,0,2,2,0,2,2,2,0,2,2,0,2,2,
2,1,1,0,0,0,2,0,2,2,2,2,2,2,0,6,2,0,2,2,
2,2,1,2,2,2,2,0,2,0,0,0,0,2,0,10,10,0,2,2,
1,2,1,2,0,0,0,0,2,0,0,0,0,2,0,0,0,0,2,2,
2,2,1,2,2,2,2,0,2,0,0,0,0,2,0,10,10,0,2,2,
2,1,1,2,2,0,2,0,2,2,2,2,2,2,0,10,10,0,2,2,
2,2,1,1,2,0,2,0,0,0,0,0,0,0,0,5,2,0,0,2,
1,2,1,2,2,0,2,2,2,2,2,0,2,2,2,2,2,2,0,2,
2,2,1,2,2,0,0,0,0,2,2,2,2,2,2,2,2,6,10,2,
2,1,1,2,2,2,2,2,2,2,2,0,2,2,0,2,2,6,10,2,
2,2,1,2,2,2,0,0,0,2,2,0,2,2,0,2,2,2,2,2,
1,2,1,0,0,0,0,10,0,0,0,0,2,2,0,0,0,0,0,2,
2,2,2,2,2,2,2,6,2,2,2,2,2,2,2,2,2,2,2,2,
