2,2,2,2,2,2,2,2,2,2,2,2,2,2,2,2,2,2,0,0,
2,2,2,2,2,2,2,2,2,2,2,2,2,2,2,2,2,2,0,0,
2,2,2,2,2,2,2,2,2,2,2,2,2,2,2,2,2,2,0,0,
0,2,2,2,2,10,2,2,10,2,2,10,2,2,10,2,2,2,0,0,
0,2,2,2,0,6,0,0,6,0,0,6,0,0,6,2,2,2,0,0,
0,2,2,2,0,10,2,2,9,2,2,10,2,2,9,2,2,2,0,0,
0,2,2,2,0,2,2,2,2,2,2,2,2,2,2,2,2,2,0,0,
0,2,2,2,0,2,2,2,2,2,2,2,2,2,2,2,2,2,0,0,
0,0,2,2,0,7,2,2,2,2,2,2,2,2,2,2,2,2,0,0,
0,0,2,2,0,2,2,2,8,2,2,8,0,4,4,4,0,0,0,0,
0,0,2,2,0,0,0,0,0,0,0,0,0,2,2,2,0,0,0,0,
0,0,2,2,2,2,2,2,2,6,6,2,0,2,5,2,0,0,11,11,
0,0,2,2,2,2,2,2,2,8,8,2,0,2,2,2,0,0,11,11,
0,0,0,2,2,2,2,2,2,2,2,2,0,0,0,0,0,0,11,11,
0,0,0,2,2,2,2,2,2,2,2,2,0,0,0,0,0,0,11,11,
11,0,0,0,0,0,0,0,0,0,0,0,0,0,11,11,11,11,11,11,
11,11,11,11,11,11,11,11,11,11,11,11,11,11,11,11,11,11,11,11,
11,11,11,11,11,11,11,11,11,11,11,11,11,11,11,11,11,11,11,11,
11,11,11,11,11,11,11,11,11,11,11,11,11,11,11,11,11,11,11,11,
11,11,11,11,11,11,11,11,11,11,11,11,11,11,11,11,11,11,11,11,