2,2,2,2,2,2,0,0,11,11,11,11,11,11,11,11,11,11,11,11,
2,2,2,2,2,2,2,0,0,11,11,11,11,11,11,11,11,11,11,11,
2,2,2,2,2,2,2,8,0,0,11,11,11,11,11,11,11,11,11,11,
0,0,8,2,2,2,2,2,2,0,0,11,11,11,11,11,11,11,11,11,
11,0,0,2,2,2,2,2,2,2,0,0,11,11,11,11,11,11,11,11,
11,11,0,0,2,2,2,2,2,2,8,0,0,11,11,11,11,11,11,11,
11,11,11,0,0,8,2,2,2,2,2,2,0,0,11,11,11,11,11,11,
11,11,11,11,0,0,2,2,2,2,2,2,2,0,0,11,11,11,11,11,
11,11,11,11,11,0,0,2,2,2,2,2,2,8,0,0,11,11,11,11,
11,11,11,11,11,11,0,0,8,2,2,2,2,2,2,0,0,11,11,11,
11,11,11,11,11,11,11,0,0,2,2,2,2,2,2,2,0,0,11,11,
11,11,11,11,11,11,11,11,0,0,2,2,2,2,2,2,8,0,0,11,
11,11,11,11,11,11,11,11,11,0,0,8,2,2,5,2,2,2,0,0,
11,11,11,11,11,11,11,11,11,11,0,0,2,2,2,2,2,2,2,0,
11,11,11,11,11,11,11,11,11,11,11,0,0,0,0,0,0,0,0,0,
11,11,11,11,11,11,11,11,11,11,11,11,0,0,0,0,0,0,0,11,
11,11,11,11,11,11,11,11,11,11,11,11,11,11,0,0,0,11,11,11,
11,11,11,11,11,11,11,11,11,11,11,11,11,11,11,11,11,11,11,11,
11,11,11,11,11,11,11,11,11,11,11,11,11,11,11,11,11,11,11,11,
11,11,11,11,11,11,11,11,11,11,11,11,11,11,11,11,11,11,11,11,