2,2,2,2,2,2,2,2,2,2,2,2,2,2,2,2,2,2,2,2,
2,2,2,2,2,2,2,2,2,2,2,2,2,2,2,2,2,2,2,2,
0,0,0,0,0,0,0,2,2,2,2,2,2,2,0,0,0,2,2,2,
2,2,2,2,2,2,0,0,0,0,2,2,2,0,0,2,0,0,2,2,
2,2,2,2,2,2,2,2,2,0,2,2,2,0,2,2,2,0,0,2,
2,2,2,2,2,2,2,2,2,0,2,2,2,0,2,2,2,0,5,5,
2,2,2,2,2,2,2,2,2,0,2,2,2,0,2,2,2,0,0,5,
2,2,2,2,2,2,2,2,2,0,2,2,2,0,2,2,2,2,0,0,
2,2,2,2,2,2,2,2,2,0,2,2,2,0,2,2,2,2,2,0,
2,2,2,2,2,2,2,2,2,0,0,2,2,0,2,2,2,2,2,0,
2,2,2,2,2,2,2,2,2,2,0,2,2,0,2,2,2,2,2,2,
2,2,2,0,2,2,2,2,2,2,0,2,2,0,0,2,2,2,2,2,
2,2,2,0,2,2,2,2,2,2,0,2,6,6,0,2,2,2,2,2,
2,2,2,0,0,7,7,7,2,0,0,2,2,6,0,2,2,2,2,2,
2,2,2,2,0,0,7,0,0,0,2,2,2,0,0,2,2,2,2,2,
2,2,2,2,2,0,0,0,2,2,2,2,2,0,2,2,2,2,2,2,
2,2,2,2,2,2,2,2,2,2,2,2,0,2,2,2,2,2,2,2,
2,2,2,0,0,2,2,2,2,2,2,0,0,2,2,2,2,2,2,2,
2,2,2,2,0,0,0,0,0,0,0,2,2,2,2,2,2,2,2,2,
2,2,2,2,2,2,2,2,2,2,2,2,2,2,2,2,2,2,2,2,
